Flag : ğŸ± ğŸ ğŸ¦‹ ğŸ•— { ğŸ˜ ğŸ¦’ @ ğŸ¦Š ğŸ¦„ _ ğŸ¢ ğŸ•’ _ ğŸ¦‹ ğŸ¦‰ @ ğŸ¦„ }


A = ğŸ¦
B = ğŸ»
C = ğŸ
D = ğŸ¶
E = ğŸ˜
F = ğŸ¦Š
G = ğŸ
H = ğŸ¦”
I = ğŸ¦‘
J = ğŸ¦“
K = ğŸ±
L = ğŸ¦
M = ğŸ¦¦
N = ğŸ¦
O = ğŸ¦‰
P = ğŸ¦‹
Q = ğŸ¦œ
R = ğŸ¦˜
S = ğŸ¦„
T = ğŸ¢
U = ğŸ¦’
V = ğŸ¦š
W = ğŸº
X = ğŸ•·
Y = ğŸ•—
Z = ğŸ¦§

Numbers and Special Characters:
0 = ğŸ•›
1 = ğŸ•
2 = ğŸ•‘
3 = ğŸ•’
4 = ğŸ•“
5 = ğŸ•”
6 = ğŸ••
7 = ğŸ•–
8 = ğŸ•—
9 = ğŸ•˜
_ = ğŸ¦–
@ = ğŸ¦•

